+--+--+--+--+
|           |
|           | 
+--+--+--+  +
|           |
+--+--+   --+
|           |
+  +--+  +  +
|  |     |  |
+  +  +--+--+
|  |        |
+  +--+--+  +
|        |  |
+   --+--+  | 
|           |
+--+--+--+  |  
|g          |
+--+--+--+--+
